##########
#@..#....#
#.#.#.#..#
#.#...#..#
##########