####.....
#..###...
#.....##.
###....@#
...#####.