############################
#..........................#
#..........................#
#..........................#
#..........................#
#..........................#
#..........................#
#...............#..........#
#............@.............#
#..........................#
#..........................#
#..........................#
#..........................#
#..........................#
#..........................#
#..........................#
#..........................#
#..........................#
############################