############0###############
#..........................#
#..........................#
#..........................#
#..........................#
#..........................#
#..........................#
#.....###.........#........#
#............@.............#
#..........................#
#..........................#
#..........................#
#..........................#
#..........................#
#..........................#
#..........................#
#..........................#
#..........................#
############################