.
.
.
.
....#############0#....
....#h..h......T#@#
....#.11####....#.#
....#..h#SDR.....I#
....#...###########
....#.#.#h...h.DDD#
....#.#.....##.##.#
....#.L#1111111...#
....#.v.#S#C#S#...#
....#.#hv.D...D.h.#
....#D..S#D..h..v.#
....#...D#..###..D#
....#S...h..SSS..v#
....#........DDDDD#
....###############
.
.
.
.